重命名 	F2
刷新窗口 	F5
右键菜单栏 shift+F10
返回上一级 Backspace


windows快捷键
最小化所有窗口	windows+M
返回桌面		windows+D
闪现桌面		windows+space
运行cmd		windows+R+cmd
打开我的电脑	windows+E
锁定电脑		windows+L
窗口最大化		windows+↑
窗口正常化		windows+↓
窗口左一半		windows+←
窗口右一半		windows+→

ctrl快捷键
关闭当前窗口 	ctrl+W
新建窗口		ctrl+N
软件中切换窗口	ctrl+Tab
另存为

alt快捷键

不同程序切换 		alt+ctrl
同上一个程序切换  	alt+esc
关闭当前窗口		alt+F4
最小化当前窗口		alt+apace+n
截屏最前窗口		alt+PrtScr

notepad++快捷键
注释本行			ctrl+Q

Excel 快捷键
文档切换			ctrl+PageUp/PageDown

